      S       S X SS
  S        S    X   
S  S   S    S   X   
  S  S    S   S X  S
             S  X   
XXXXXXXXXXX     XXXX
S S       X     X S 
     S S SX  S XX   
      XXXXXXXXXXX   
   S  XS  X        S
  S   X   X    S    
      X   X S       
 S  S X  SX     S  S
      W   X  S      
          X  S  S   
     S    X         
  S       X S     S 
      XXXXXXXXX     
      X       X S   
      X S  S  X     
