S S SS S X   S      
         X  S S  S S
  S S    X  S       
  S   S  X  S S  S  
    S    X          
  S  S   XXXXXXXXXXX
 S    S      S  X   
         SS    XX   
XXXXXXXXXXWXXXXXX  S
  S    S  X S     S 
          X         
    S     X   S   S 
   S  S   X         
          X  SS  S  
   SS     X     S   
  SSSS    X  S S    
 SSSSSS   X    S    
  SSS S   XSS    S  
 S      S X    S SS 
     S  S X S S S  S
